111111111111111111111111111111
10C000000000001000000000000001
10000P0000000010000G0000000001
10000000000000100000G000000001
10000000000000100000000000G001
10000000000000100G000000000001
100000000000001000000G00000001
100000000000000000000000000001
100000000000001000000000000001
100000000000001000000000000001
10000000000000100000G000000001
10000000000000100000000000E001
111111111111111111111111111111