111111111111111111111111111111
100000000000001000000000000001
11100P000000001000000000000001
1C0000000000001000000000000001
111000000000001000000000000001
100000000000001000000000000001
100000000000001000000000000001
100000000000000000000000000001
100000000000001000000000000001
100000000000001000000000000001
100000000000001000000000000001
10000000000000100000000000E001
111111111111111111111111111111