111111111111111111111111111111
100000000000001000000000000001
11100P000000001000000000000001
1C000000000S001000000000000001
111000000000001000000000000001
100000000000001000000000000001
100000000000001000000000000001
1000000000000000000000000E0001
100000000000001000000000000001
100000000000001000000000000001
100000000000001000000000000001
100000000000001000000000000001
111111111111111111111111111111