111111111111111111111111111111
1WCWWWWWWWWWWW1WWWWWWWWWWWWWW1
1WWWPWWWEWWWWW1WWWWWWWWWWWWWW1
1WWWWWWWWWWWWW1WWWWWWWWWWWWWW1
1WWWWWWWWWWWWW1WWWWWWWWWWWWWW1
1WWWWWWWWWWWWW1WWWWWWWWWWWWWW1
1WWWWWWWWWWWWW1WWWWWWWWWWWWWW1
1WWWWWWWWWWWWW1WWWWWWWWWWWWWW1
1WWWWWWWWWWWWW1WWWWWWWWWWWWWW1
1WWWWWWWWWWWWW1WWWWWWWWWWWWWW1
1WWWWWWWWWWWWW1WWWWWWWWWWWWWW1
1WWWWWWWWWWWWWWWWWWWWWWWWWWWW1
111111111111111111111111111111