111111111111111111111111111111
10C000000000001000000000000001
1000P000E000001000000000000001
10000000000000100G000000000001
100000000000001000000000000001
100000000000001000000000000001
1000000000000010G0000000000001
100000000000001000000000000001
100000000000001000000000000001
100000000000001000000000000001
100000000000001000000000000001
100000000000000000000000000001
111111111111111111111111111111