111111111111111111111111111111
100000000000001000000000000001
11100P001S00001000000000000001
1C0000000S00001000000000000001
11100E000000001000000000000001
100000000000001000000000000001
100000000000001000000000000001
100000000000000000000000000001
100000000000001000000000000001
100000000000001000000000000001
100000000000001000000000000001
100000000000001000000000000001
111111111111111111111111111111