111111111111111111111111111111
10C000100000000P00000000000001
100001000000000000000000000001
100001000000000000000000000001
100001000000000000000000000001
100001000000000000000000000001
100001000000000000000000000001
100001000000000000000000000001
100001000000000000000000000001
100001000000000000000000000001
100001000000000000000000000001
100001000000000000000000000001
100001000000000000000000000001
100001000000000000000000000001
100001000000000000000000000001
100001000000000000000000000001
100000000000000000000000000001
1000000000000000000000000000E1
111111111111111111111111111111