111111111111111111111111111111
10C000000000000000000000000001
1000P000E000000000000000000001
100000000000000000000000000001
100000000000000000000000000001
100000000000000000000000000001
100000000W00000000000000000001
100000000000000000000000000001
100000000000000000000000000001
100000000000000000000000000001
100000000000000000000000000001
100000000000000000000000000001
111111111111111111111111111111