111111111111111111111111111111
10C00P100000000000000000000001
100001000000000000000000000001
100001000000000000000000000001
100001000000000000000000000001
100001000000000000000000000001
100001000000000000000000000001
100001000000000000000000000001
100001000000000000000000000001
100001000000000000000000000001
100001000000000000000000000001
100001000000000000000000000001
100001000000000000000000000001
100001000000000000000000000001
100001000000000000000000000001
100001000000000000000000000001
100000000000000000000000000001
1000000000000000000000000000E1
111111111111111111111111111111