11111111
10C00001
10000001
100000P1
100000E1
11111111