11111111111
10CP0000001
10000000001
10000000001
10000000001
10000000001
10000000001
100000000E1
11111111111