11111111
10CP0001
10000001
10000001
100000E1
11111111