111111111111111111111111111111
10C000000000001000000000000001
10000P000000001000000000000001
100000000000001000000000000001
100000000000001000000000000001
10000000000000100S000000000001
100000000000001000000000000001
100000000000000000000000000001
100000000000001000000000000001
100000000000001000000000000001
100000000000001000000000000001
10000000000000100000000000E001
111111111111111111111111111111