111111111111111111111111111111
100000000000001000000000000001
11100PS00000001000000000000001
1C000000SS00001000000000000001
11100E00SS00001000000000000001
100000000000001000000000000001
100000000000001000000000000001
100000000000000000000000000001
100000000000001000000000000001
100000000000001000000000000001
100000000000001000000000000001
100000000000001000000000000001
111111111111111111111111111111