111111111111111111
10CP00000000000001
100000000000000001
100000000000000001
100011111111110001
100000000000000001
100011111111110001
100000000000000001
100000000000000001
100000000000000001
100000000000000001
1000000000000000E1
111111111111111111