11111111111111111
10C00000000000001
10P00000000000001
10000100000000001
10000100000000001
10000100000000001
10000100000000001
10000100000000001
10000100000000001
10000100000000001
10000100000000001
10000100000000001
10000100000000001
10000100000000001
10000100000000001
10000100000000001
10000000000000001
100000000000000E1
11111111111111111