111111111111111111111111111111
1GCGGGGGGGGGGG1GGGGGGGGGGGGGG1
1GGGPGGGEGGGGG1GGGGGGGGGGGGGG1
1GGGGGGGGGGGGG1GGGGGGGGGGGGGG1
1GGGGGGGGGGGGG1GGGGGGGGGGGGGG1
1GGGGGGGGGGGGG1GGGGGGGGGGGGGG1
1GGGGGGGGGGGGG1GGGGGGGGGGGGGG1
1GGGGGGGGGGGGG1GGGGGGGGGGGGGG1
1GGGGGGGGGGGGG1GGGGGGGGGGGGGG1
1GGGGGGGGGGGGG1GGGGGGGGGGGGGG1
1GGGGGGGGGGGGG1GGGGGGGGGGGGGG1
1GGGGGGGGGGGGGGGGGGGGGGGGGGGG1
111111111111111111111111111111