111111111111111111111111111111
10C000000000001000000000000001
1000P00000000010000G0000000001
100000000000001000000000000001
100000000000001000000000000001
100000000000001000000000000001
100000000000001000000000000001
100000000000001000000000000001
100000000000001000000000000001
100000000000001000000000000001
100000000000001000000000000001
10000000000000000000000000E001
111111111111111111111111111111