1111111111111111111111111111111
1C00000000C000000000C00000000C1
1000000000000000000000000000001
1000000000000000000000000000001
1000000000000000000000000000001
1000000000000000000000000000001
1C000000000000000000000000000C1
1000000000000000000000000000001
1000000000000000000000000000001
100000000000000P000000000000001
1000000000000000000000000000001
1000000000000000000000000000001
1C000000000000000000000000000C1
1000000000000000000000000000001
1000000000000000000000000000001
1000000000000000000000000000001
10000000000000000000000000000C1
1C00000000C000000000C0000000CE1
1111111111111111111111111111111