1111111111
1000000001
10001C0001
1P11100001
1011100E01
1000000001
1111111111