111111111
10C00P101
100000001
100111101
1000000E1
111111111