1111111111
1000000001
10001C0001
1P11100001
1011100001
10000000E1
1111111111