111111111
1PC00WW01
1000000E1
111111111