1111111111
1000000001
10001C0001
1P1111G001
1011110E01
1000000001
1111111111