111111111
10C00P001
100000001
1000000E1
111111111