1111111111
100P1C0001
1011100001
1000100001
10000000E1
1111111111