111111111
10C00P101
100000001
1000010E1
111111111