1111111111111111111111111111111111111111111111111111111111111111
1000000000000000000000000000000000000000000000000000000000000001
1001110000000001000111100100011100100010111100010010001001111001
1010001010001011101000001110100010110010010010000011001010000001
1010001010001001000111000100111110101010010010110010101010111101
1010001010001001000000100100100010100110010010010010011010001001
1001110001110000101111000010100010100010111100111010001001110001
1000000000000000000000000000000000000000000000000000000000000001
1111111111111111111111111111111111111111111111111111111111111111
1PCCCCCCCCCCCCCCCCCCCCCCCCCCCCCCCCCCCCCCCCCCCCCCCCCCCCCCCCCCCCE1
1111111111111111111111111111111111111111111111111111111111111111